R 720 568
S ./texture/SPRITE.xpm
C 3,80,180
F 44,44,44



NO ./texture/red.xpm
SO ./texture/red.xpm
WE ./texture/red.xpm
EA ./texture/red.xpm









1111111111111111111111111111111111111111111111
1000000000001100000000000000000000000000000001
10000000W0001100000000000020001111110000000001
1000000001111111111111100000000011000000000001
1020000000111122111111110000000000000000000001
1000000001111111111111100022000000011111000001
1000000000000000000000000000000000000000000001
1000000000000000000000000000000000000000000001
1000000000000000200000000000000000010000000001
1222020000000000200000002200000001111111111111
1000000000000011100000000000000001
1000000000000001100000000000000011
1000000002220000200000000022110011
1000000000000000200000000000000001
1111110000011111111111111111111111
     1000000001
     1000000001
     1000200001
     1111111111

              
            
           
           






